{
    "dungeons": [
      {
        "name": "Test Dungeon",
        "tile_size": 80,
        "layout": [
          [1,1,1,1,1,1,1,1,1,1,1,1,1,1,1,1],
          [1,0,0,0,1,0,0,0,0,0,0,1,0,0,0,1],
          [1,0,1,0,1,0,1,1,1,1,0,1,0,1,0,1],
          [1,0,1,0,0,0,0,0,0,1,0,1,0,1,0,1],
          [1,0,1,1,1,1,1,1,0,1,0,1,0,1,0,1],
          [1,0,0,0,0,0,0,1,0,0,0,0,0,0,0,1],
          [1,1,1,1,1,1,0,1,1,1,1,1,1,0,0,1],
          [1,0,0,0,0,0,0,0,0,0,0,0,0,1,2,1],
          [1,1,1,1,1,1,1,1,1,1,1,1,1,1,1,1]
        ],
        "player_start": [1,1],
        "exit_position": [13,6]
      }
    ]
  }
  